%%%%%%%%%%%%%%%%%%%%
%                  %
%                  %
%                  %
%                  %
%  %%%%%%%%%%%%%%%%%
%                  %
%%%%%%%%%%%%       %
%                  %
%                  %
%    %%%%%%%%%%%%%%%
%                  %
%       %          %
%       %          %
%       %          %
%       %          %
%       %          %
% %%%%%%%          %
%.%               P%
%%%%%%%%%%%%%%%%%%%%