%%%%%%%%%%%%%%%%%%%%%%%%%%%%%%%%%%%
%                                P%
%                  %%%%%%%%%%%%%% %
%                                 %
%                  %%%%%%%%%%%%%%%%
%  %%%%%%%%%%%%%%%%%%             %
%                                 %
%%%%%%%%%%%%                      %
%                                 %
%                                 %
%    %%%%%%%%%%%%%%%%             %
%%%%%%%%%%%%%%%                   %
%       %%          %            %%
%       %%          %            %%
%       %%          %            %%
%       %%          %            %%
%       %%          %%           %%
%           %%%                   %
%        %%%%%%%%%%%%%%%%         %
%                      %%%%       %
%%%%%%%%%%%%%%%%%      %%%%       %
%                      %%%%       %
%                      %%%%       %
%                      %%%%       %
%                      %%%%       %
%         %%%%%%%%%%%%%%%         %
%                      %%%%       %
%                      %%%%       %
%.   %%%%%%%%%%%%%%%%             %
%%%%%%%%%%%%%%%%%%%%%%%%%%%%%%%%%%%