%%%%%%%%%%%%%%%%%%%%%%
%                   P%
%%%%%%%%%%%%%%%%%    %
%                    %
%                    %
%  %%%%%%%%%%%%%%%%%%%
%                    %
%%%%%%%%%%%%         %
%                    %
%                    %
%    %%%%%%%%%%%%%%%%%
%                    %
%       %%    %      %
%       %%    %      %
%       %%    %      %
%       %%    %      %
%       %%    %      %
%%%%%%%%%%%%%%%      %
%.                   %
%%%%%%%%%%%%%%%%%%%%%%